12 20
11111101111111111111
11000101111111111111
1111010111111111E111
11110101111111110111
11110001111111000111
11111111011110001111
11000000000111001111
11110011111000011111
11110000000110111111
11110111111100111111
11100000000000000111
11111110111111011111

